OpCode	TapeReader	Depth	Comment	Info5Name	Info5Value	Info6Name	Info6Value	Info7Name	Info7Value	Info8Name	Info8Value	Info9Name	Info9Value	Info10Name	Info10Value	Info11Name	Info11Value	Info12Name	Info12Value
PCB11	Kaitlin																		
PCB12	Henry																		
PCB13	Kaitlin																		
PCB16	Kaitlin																		
PCB2	Henry																		
PCB21	Kaitlin																		
PCB25	Henry																		
PCB28	Kaitlin																		
PCB29	Henry																		
PCB3	Henry																		
PCB30	Kaitlin																		
PCB4	Kaitlin																		
PCB9	Kaitlin																		
PCBP1	Kaitlin																		
PCBP10	Kaitlin																		
PCBP11	Kaitlin																		
PCBP13	Henry																		
PCBP14	Henry																		
PCBP15	Kaitlin																		
PCBP16	Kaitlin																		
PCBP17	Henry																		
PCBP18	Kaitlin																		
PCBP3	Henry																		
PCBP6	Henry																		
PCBP7	Kaitlin																		
PCBP8	Kaitlin																		
PCBP9	Levi																		
PCBRUV1	Henry																		
PCBRUV14	Hannah Williams																		
PCBRUV15	Levi																		
PCBRUV18	Hannah																		
PCBRUV19	Daniel Agnello																		
PCBRUV20	Hannah Williams																		
PCBRUV22	Levi																		
PCBRUV23	Daniel Agnello																		
PCBRUV24	Daniel																		
PCBRUV26	Hannah Williams																		
PCPREF4.True	Daniel Agnello																		
PCBRUV27	Hannah Williams																		
PCBRUV5	Hannah Williams																		
PCBRUV7	Levi																		
PCBRUV8	Hannah Williams																		
PCPREF12	Hannah Williams																		
PCPREF2	Hannah Williams																		
PCPREF4	Daniel Agnello																		
PCPREF5	Hannah																		
